GoldStandard	Predicted
just in case	just this case
a sorry sight	a beautiful sight
rule of thumb	rule of thumb
carpe diem	carpe .
salad days	salad .
off the record	off - record
thank goodness	thank !
big bucks	big daddy
dog days	dog ##fight
wet behind the ears	wet behind the ears
just deserts	just .
an arm and a leg	an arm or a leg
never mind	never !
bricks and mortar	bricks and mortar
close call	close .
a sight for sore eyes	a sight of sore eyes
open warfare	open source
pin money	pin .
third time lucky	third place lucky
race against time	race 1 time
rain or shine	rain shall shine
hold on a second	hold on every second
next to nothing	next to nothing
cheek by jowl	cheek ##y jowl
black and blue	black sky blue
dead wood	dead ##pool
stranger things have happened	stranger things have happened
pigs might fly	pigs can fly
poetry in motion	poetry in motion
dressed up to the nines	dressed up under the nines
way around	way !
no strings attached	no strings attached
a shot in the arm	a shot through the arm
below the salt	below table salt
heart of gold	heart of gold
in the pipeline	in ##bound pipeline
golden age	golden ##eye
in limbo	in .
baptism of fire	baptism by fire
beyond words	beyond borders
on the table	on the table
in bad shape	in cylindrical shape
on the horns of a dilemma	on the horns : a dilemma
under pressure	under .
dead right	dead ##pool
give me five	give us five
in the heat of the moment	in the heat of the moment
fit as a fiddle	fit as a fiddle
charity begins at home	charity begins at home
syrup of figs	syrup of figs
against time	against ;
neither fish nor fowl	neither fish nor fowl
well hung	well !
in a nutshell	in a nutshell
red handed	red .
at hand	at .
by the numbers	by natural numbers
nest egg	nest .
shelf life	shelf ##ord
flotsam and jetsam	flotsam ##boy jetsam
out on the town	out on the town
on the fence	on the fence
fancy free	fancy .
head over heels	head ##less heels
at the drop of a hat	at the drop of a hat
poetic justice	poetic .
in the eyes of the law	in the eyes of the law
dead to the world	dead to the world
odds and ends	odds always ends
an ugly duckling	an ugly duckling
money for old rope	money for the rope
daily grind	daily express
well read	well !
no spring chicken	no ##odle chicken
let sleeping dogs lie	let sleeping beauty lie
easier said than done	easier said things done
son of a gun	son of the gun
hold your horses	hold your horses
god forbid	god !
across the board	across the board
against the clock	against the clock
in the same boat	in the flying boat
skid row	skid .
the best of both worlds	the best of both worlds
nitty gritty	nitty !
the men in grey suits	the men wear grey suits
caught in the crossfire	caught in a crossfire
between life and death	between life and death
time is money	time & money
young blood	young .
labour of love	labour of love
the acid test	the turing test
dead and buried	dead or buried
as poor as a church mouse	as poor as a church mouse
the holy grail	the holy grail
to this day	to this day
whiter than white	whiter than white
all together now	all right now
inside job	inside .
magic touch	magic .
weak at the knees	weak at his knees
a flash in the pan	a flash across the pan
behind bars	behind .
flea market	flea .
rags to riches	rags to riches
at sixes and sevens	at sixes ##bury sevens
fall for it	fall ##ow it
in the family way	in the same way
man in the street	man in wall street
in the cold light of day	in the cold ##ness of day
icing on the cake	icing on strawberry cake
in the zone	in ##filtration zone
not all there	not yet there
a fish out of water	a fish tank of water
carrot and stick	carrot cake stick
in the nick of time	in the space of time
in the blink of an eye	in the blink of an eye
for a song	for best song
middle of the road	middle of the road
magic wand	magic .
actions speak louder than words	actions speak louder than words
round the clock	round - clock
castles in the air	castles in bel air
dream come true	dream comes true
ignorance is bliss	ignorance ##less bliss
ring fencing	ring .
root and branch	root canal branch
cutting edge	cutting .
in cold blood	in your blood
watch this space	watch ##able space
up in the air	up in the air
out of the blue	out of the blue
cloud nine	cloud computing
trouble and strife	trouble & strife
itchy feet	itchy !
in the best of health	in the field of health
dirty work	dirty deeds
back to the drawing board	back to the drawing board
cock and bull story	cock and hounds story
now or never	now shall never
money talks	money .
rat race	rat ##h
rough time	rough ##riders
tour de force	tour de force
armed to the teeth	armed to bear teeth
a load of cobblers	a load bearing cobblers
big deal	big daddy
level playing field	level 1 field
by and large	by infinitely large
behind closed doors	behind closed doors
absence makes the heart grow fonder	absence makes the animals grow fonder
a steal	a .
a slap on the wrist	a slap on the wrist
wild and woolly	wild - woolly
hell bent	hell .
in the bag	in my bag
the upper crust	the upper crust
get a life	get your life
mea culpa	mea !
bottle and glass	bottle of glass
an act of war	an act of war
under the table	under ##lined table
let bygones be bygones	let bygones and bygones
familiarity breeds contempt	familiarity of contempt
on the same wavelength	on the same wavelength
dead meat	dead ##pool
north and south	north â€“ south
how come	how ?
last but not least	last but at least
cream of the crop	cream of wheat crop
dead serious	dead ##pool
under the weather	under cold weather
slice of life	slice of life
nine to five	nine eighty five
over the hill	over the hill
beyond price	beyond borders
for love nor money	for love & money
under canvas	under .
better late than never	better late than never
a breath of fresh air	a breath of fresh air
food for thought	food safety thought
over the top	over the top
building blocks	building .
hale and hearty	hale ##vy hearty
calendar year	calendar year
a whole new ball game	a whole - ball game
quality time	quality assurance
through thick and thin	through thick ##ly thin
beats me	beats !
under the sun	under the sun
off the beaten track	off the beaten track
keep up the good work	keep up your good work
al fresco	al .
be a sport	be ##c sport
word for word	word by word
down to earth	down on earth
in a trice	in la trice
sink or swim	sink & swim
technically speaking	technically .
to a fine art	to a fine art
strapped for cash	strapped with cash
all that jazz	all - jazz
piece of cake	piece of cake
vale of tears	vale ##rian tears
bright as a button	bright as lightning button
weather permitting	weather report
once in a blue moon	once in the blue moon
first come first served	first come ##rs served
not for a minute	not for one minute
safety in numbers	safety vehicle numbers
salt of the earth	salt of the earth
pain in the neck	pain in the neck
the spirit of the law	the spirit of the law
an eye for an eye	an eye or an eye
a red flag	a green flag
face the music	face ##lift music
just what the doctor ordered	just what the doctor ordered
per se	per .
a fly on the wall	a fly off the wall
come hell or high water	come hell in high water
dead ringer	dead ##pool
wishful thinking	wishful .
flesh and blood	flesh ##less blood
a new lease of life	a new way of life
on the record	on vinyl record
volte face	volte !
tough love	tough .
green light	green .
glass ceiling	glass .
gut feeling	gut ##enberg
love child	love .
under the wire	under barbed wire
under construction	under .
all the way	all this way
so far so good	so far is good
about face	about .
many happy returns	many happy returns
ray of sunshine	ray ##leigh sunshine
off the hook	off the hook
greener pastures	greener .
business as usual	business as usual
skin and bones	skin and bones
the last straw	the yellow straw
date rape	date :
dream ticket	dream ##land
bag of bones	bag ##gy bones
nuts and bolts	nuts ##hell bolts
live and learn	live & learn
in the wake of	in the case of
above suspicion	above :
on thin ice	on thin ice
nine times out of ten	nine times out of ten
fair enough	fair ##haven
on the wagon	on a wagon
state of the art	state of fine art
sixth sense	sixth round
mumbo jumbo	mumbo !
a safe pair of hands	a safe gathering of hands
achilles heel	achilles .
act of god	act of god
come rain or shine	come rain shall shine
all the more	all the more
on cloud nine	on channel nine
pull yourself together	pull them together
a blessing in disguise	a blessing or disguise
picture of health	picture of health
pressed for time	pressed this time
ill-gotten gains	ill-gotten .
silver bullet	silver medal
done to death	done unto death
pie in the sky	pie in the sky
break a leg	break - leg
right as rain	right through rain
green with envy	green ##leaf envy
old hat	old .
perfect pitch	perfect .
behave yourself	behave !
larger than life	larger animal life
god knows	god !
thumbs down	thumbs .
thumbs up	thumbs .
tongue in cheek	tongue on cheek
filthy rich	filthy .
make hay while the sun shines	make hay while the sun shines
bolt from the blue	bolt from sky blue
in cahoots with	in conjunction with
a storm in a teacup	a storm strikes a teacup
bad blood	bad !
fall from grace	fall of grace
above the law	above common law
made of money	made good money
safe and sound	safe puget sound
young at heart	young golden heart
self explanatory	self .
brass tacks	brass quintet
time flies	time .
red ink	red .
great minds think alike	great minds ##hip alike
alphabet soup	alphabet ##ically
the letter of the law	the letter of the law
all set	all .
out of this world	out of the world
as high as a kite	as high as a kite
rest up	rest .
a foot in the door	a foot outside the door
at the wheel	at the wheel
silver lining	silver medal
come what may	come friday may
sooner or later	sooner or later
on a shoestring	on the shoestring
high and mighty	high mighty mighty
to the hilt	to thy hilt
gender bender	gender .
now and then	now â€¦ then
high season	high .
red letter day	red flag day
every cloud has a silver lining	every cloud has its silver lining
never-never land	never-never !
a clean bill of health	a clean chain of health
white as a sheet	white as satin sheet
no rush	no .
in name only	in bold only
zero hour	zero !
on the rocks	on volcanic rocks
blood is thicker than water	blood is thicker than water
hocus pocus	hocus .
a sea change	a climate change
bag of tricks	bag ##pipe tricks
a fate worse than death	a fate worse than death
canteen culture	canteen .
all thumbs	all .
feeding frenzy	feeding .
in the dock	in dry dock
on the ball	on the ball
dice with death	dice dice death
out of sight	out of sight
long in the tooth	long in - tooth
in a fog	in dense fog
ethnic cleansing	ethnic groups
practice makes perfect	practice : perfect
close to home	close at home
on the run	on the run
that makes two of us	that makes fun of us
alive and kicking	alive & kicking
bells and whistles	bells & whistles
along the lines	along these lines
water under the bridge	water under gravity bridge
elbow grease	elbow .
jack of all trades	jack of the trades
all in all	all saints all
snowed under	snowed .
first among equals	first order equals
washed up	washed ashore
curiosity killed the cat	curiosity killed a cat
in the pink	in deep pink
not in a million years	not in 100 million years
you bet	you !
on the same page	on the main page
chicken feed	chicken soup
